NO ./texture/path_to_the_north_texture
SO ./texture/path_to_the_south_texture
EA ./texture/path_to_the_east_texture
WE ./texture/path_to_the_west_texture


F 220,100,45
C 225,30,0




111111111111111111111
110000010000000000111
110000010000000100011
110000010000000010011
110000000000000100011
1100000N0000000000011
111111111111111111111