NO /NO.xmp
SO /SO.xmp
EA /EA.xmp
WE /WE.xmp
C 100,100,100
F 100,1000,100

11111111111111111111111111111111111111111111111111
10000000000100000000010000001001001000101000000001
11001110010000000100010011100100010010000100000101
10010001100100001001100100010001001000110001000101
10000000000100010010001000101110100110000100101001
10011100010100010010010010000000010000110010000011
10100011001000100001001001001100100111000001010001
10101000100100001000100100010010001000101101010101
11001100110101000101000110010001101010010010001001
10010001000001010101001000100100001001010001101001
10100111110010010110010011000100001101000100001001
10101001000000010000010100010000010001100010000101
10100100001110010110010010001100010110001001010001
10100011000000001000101010100001100000000100101001
10001000011001000101000000011010001001000011000101
10010111100101100100011011100010100100110100010001
10010000000100000000100100001010010010001000100001
11010010111010010010100000110001011010100001001011
10010100000001010100001011000101000001000110001001
10100101111001010110000100010000010100101000000101
10001000000101010001001001001011100100101001110101
11001111001001011100010010000000000100010010000001
10000000101001000001001011010111110001000101011101
10011110001010000010001000100000001010001000100011
10100001001001011101010010000111100000101010101001
10111100011100000000100000101000010000010010000101
10000011001001110100000010101001001100100000001001
10001000100010001010000100101011100011000111010001
10001110011100101010110011001001011000001000100101
10000001000001001010001000001000000100100010001001
10011001101110001000000010000111000100010100001001
10100010010000110000101101111000000000100101110101
1010S000010110000100010000000010010011001000000101
10100111100001010011100001100000001000001100010101
10001000001100010100011010010011100100110000100101
10110010100010010001000010000100010101000110101001
10000101000010011101111100101001011001110001001001
10001001000010100000000010100010000100000101000101
10001010011001001010010100011100110000101001011001
11010011100100001001001001100010000011001010000001
10010100010011100100101010001010100000010010001101
10010001001000010100101000010010111011100010110011
10001010100110100010100100010001000100000100000001
10110100001000101000010011100100010000001001010011
10000100010011000101001000000010100011001001010001
10100001001000000100101001100001001000010010010011
10101010001001110010001010000110001010000100100101
10100100110010001010001100011001001100101001000101
10010001000000100010000001000000000000100001000001
11111111111111111111111111111111111111111111111111
